first_name	last_name	Company
Micky	Dormand	Grant-Ward
Patrice	Wagon	Rolfson Group
Murry	Ovitz	Wehner-Harber
Nollie	Stille	Beahan-Zieme
Jarrid	Mazzei	Kuvalis Inc
Kyla	Billam	Mitchell Group
Eimile	Balsdon	Krajcik Inc
Jade	Lockless	Robel, McLaughlin and Ziemann
Darla	Cheyne	Lemke, Waters and Carroll
Cass	Waleworke	Borer-Murazik
Roxy	Godard	Kozey-Lubowitz
Mayne	Manion	Johnston Group
Karyn	MacCafferky	Nienow-Lynch
Appolonia	Nouch	Kulas-Goyette
Rocky	Tatchell	Lubowitz-Friesen
Valentina	Pettman	Witting and Sons
Kylie	Klais	Glover, Yundt and Luettgen
Marcella	Tudgay	Mante-Stracke
Scottie	Boardman	Wiza-Ernser
Sigrid	Inchley	Raynor and Sons
Gaultiero	Olech	Prosacco, Schaden and Cassin
Lanae	Burde	Lynch and Sons
Nikki	Ridgway	Moore, Lindgren and Homenick
Mirella	Iannetti	Fisher, Russel and Veum
Shena	Egel	Lehner Inc
Ainsley	Reaney	Blanda-Mann
Sibylla	Mauditt	Lind-VonRueden
Hirsch	Stud	Haley, Turcotte and Sauer
Fianna	Faussett	Spencer-Frami
Vidovik	Assender	Schmeler, Larkin and Conroy
Poppy	Neame	Block and Sons
Katheryn	Marcome	Deckow LLC
Dov	Anespie	Abbott, Hilpert and Stoltenberg
Trumaine	Britland	Altenwerth and Sons
Lizzie	Serotsky	Schuster-Lehner
Reine	Puddicombe	Towne Group
Mair	Hullin	Wolff, Frami and Hayes
Levey	Begwell	Stehr and Sons
Roley	Stienham	Roob, Ziemann and O'Reilly
Justen	Shirrell	Beatty-Abernathy
Elysee	Woonton	Green LLC
Vasily	McKeady	Wolf, Keebler and Jenkins
Sapphire	Severs	Schuppe Group
Simmonds	Leil	Ratke-Bergstrom
Arline	McLennan	Bartoletti-Kuphal
Roth	Gailor	Wolf, Parker and Breitenberg
Cally	Brookshaw	Jacobs-Hahn
Ryon	Mingotti	Thompson-Harris
Dorena	Rivel	Rohan, Heidenreich and Johnston
Devonne	Lazar	Zemlak-Green
Bendix	Sturm	Bechtelar-Reichert
Brunhilde	Elderton	Ziemann, Waters and Mayert
Grover	Creek	Sporer Group
Randy	Nijssen	Fahey and Sons
Juliana	Kuzemka	Weimann-Kutch
Sherie	Foulstone	Langworth and Sons
Rhodia	Gawkes	Price, Keebler and Johns
Simeon	Hillhouse	Gusikowski, Shanahan and Satterfield
Hyacinthia	Deluce	Kuhic Group
Ozzie	Danilyak	Fay-Kuhic
Jesus	Mableson	Kunde-Morissette
Gerta	Crewes	Bode-Von
Sybille	Hasard	Reichert, Morissette and Sawayn
Jemmy	Drinkel	Conn-D'Amore
Kati	Hedingham	Mraz-Mayer
Brunhilda	Coton	Heidenreich-White
Brice	Colville	Halvorson-Lemke
Tudor	Fraschini	Hackett and Sons
Odetta	Paradin	Hickle Inc
Mikol	Corten	Nitzsche, Rodriguez and Spinka
Mommy	Kimberly	King Inc
Peter	Ruste	Moen-Stracke
Francoise	Jennrich	Ward Inc
Hastie	Sabatini	Connelly Inc
Peadar	Brisset	Streich, Stark and Hilpert
Gasparo	Cuerda	Graham, Marvin and Kshlerin
Stillman	Mollen	Mosciski, Greenfelder and Frami
Bail	Nuss	Raynor-O'Reilly
Blancha	Norfolk	Powlowski LLC
Aeriell	McGillivray	Lebsack-Waelchi
Rice	Hurren	Wilkinson-Bogan
Blythe	Janodet	Kris Group
Mario	Haslin	Rowe, Howe and Hayes
Kiri	Hadwen	Zboncak, Dibbert and Hagenes
Rorke	Gook	Streich Group
Sarine	Sincock	Prohaska Group
Melloney	Semorad	Sporer and Sons
Pepi	Ickowicz	Bashirian-Stoltenberg
Townsend	Robic	Ortiz and Sons
Tiffy	Bault	Schinner Inc
Danni	Warburton	Erdman Inc
Shena	Fenwick	Marquardt and Sons
Luciana	Bruford	Bogisich-Carter
Alana	Annatt	Gerhold, Nader and Friesen
Josephine	Bletcher	Blick-Schumm
Lurleen	Crooke	Hessel, Kozey and Hahn
Lauren	Neilands	Lindgren, Hettinger and Effertz
Page	Eivers	Hintz, Schiller and Stroman
Tatiania	Drage	Roberts, Littel and McLaughlin
Elvis	Blanque	Hilpert Group
Hettie	Minster	Quitzon and Sons
Julianne	Gaggen	Labadie-O'Keefe
Ramsay	Hartas	O'Keefe, Boehm and Murphy
Jordon	Brotheridge	Hansen, Strosin and Moore
Jessalin	Gough	Langworth and Sons
Barclay	Bemlott	Farrell and Sons
Lurleen	Yoakley	Douglas, Hayes and Kirlin
Meredithe	Eldon	Franecki, Legros and Balistreri
Kahlil	Bunny	Zulauf, Kilback and Friesen
Wayland	Lindenbaum	Runolfsson, Mueller and Gerlach
Keriann	Perett	Windler-Rau
Dalston	Youngs	Anderson-Cronin
Stacy	Orrice	Weimann Group
Coriss	Stilly	Brakus-Stamm
Trudi	Roscow	Bahringer, Ziemann and McGlynn
Marthe	Kunze	Abshire-Bahringer
Florida	Willshee	Olson-Bauch
Reube	Weatherburn	Spencer LLC
Clarence	Theyer	Stiedemann Inc
Reinold	Heinig	Bednar LLC
Nikolos	Denyukhin	Olson and Sons
Briggs	Izkovitz	Beer, Kling and Sipes
Sybille	Durdle	Ratke-Eichmann
Benn	Bossons	Bartell, Luettgen and Walker
Ruthy	Babcock	Glover-Johns
Kassandra	Arkle	Brown-Marks
Colan	Pawnsford	Dach LLC
Niccolo	Plaster	O'Conner Inc
Florie	Laurie	Hyatt Inc
Charil	Ruos	Carroll-Lemke
Karlen	Hoyle	Schinner-MacGyver
Louisette	Merwe	O'Kon-Hettinger
Vicky	Romaint	Huels-Bode
Janessa	Antoniewicz	Wolff Inc
Tomkin	Vorley	Jones, Stokes and Sawayn
Lola	Alvarez	Flatley-Walsh
Tallie	Kneeshaw	Homenick Inc
Bobinette	Mabley	Barton and Sons
Porter	Guyer	Orn LLC
Stewart	Lindro	Kunze-Mohr
Ricard	Dilke	Terry, Gleason and Parisian
Alayne	Renol	Mraz LLC
Josh	Lowne	Yost Inc
Hortensia	Jayume	Gutkowski, Schaefer and Donnelly
Malena	Frediani	Gulgowski Inc
Greg	Libbis	Cassin, Bogan and Pacocha
Hasheem	Waberer	Boyer-Jacobs
Yulma	Wooler	Pfannerstill-Breitenberg
Clywd	Soppit	Glover, Nienow and Farrell
Philippine	Tather	Spinka, Carroll and Kulas
Sacha	Kimmitt	Leffler LLC
Sumner	Topes	Johnston, Beahan and Torphy
Dayna	Heaffey	Willms-Hintz
Marie	Viscovi	Quitzon LLC
Kalila	Scriver	White, Cronin and Yundt
Agnese	Slowey	Bergstrom-Beahan
Bernardine	Hearthfield	Barton-Kuhic
Sholom	Godbert	Connelly-Quigley
Clifford	Pearson	Ferry, Batz and Flatley
Biron	Parkins	VonRueden Inc
Morena	Torbett	Stracke Group
Putnem	Lawry	Wunsch LLC
Shadow	Giovanizio	Ortiz, Brakus and Jacobson
Dorry	Eldritt	Thompson, Mayert and Stark
Tonnie	O'Looney	Koepp-Haley
Blinnie	Dumingo	Schuster Group
Beatrice	Newton	Wuckert-Dickens
Daryn	Grisard	Grant-Fay
Dell	Astley	Jacobi, Simonis and Walker
Morgana	Sarfass	Wunsch LLC
Stephannie	Sapsford	Bechtelar and Sons
Cal	Mattiacci	D'Amore-Pagac
Kamila	Rand	Hand Inc
Lynn	Shatford	Kiehn LLC
Giuseppe	Dunseath	Mills LLC
Ami	Bubb	Crooks Inc
Thorpe	Bricknell	Kertzmann and Sons
Valerye	Lazarus	Bartell, Schuppe and Davis
Joann	Fleetwood	Tromp-Wolff
Muriel	Bruckner	Donnelly and Sons
Nichole	Lundy	Jacobi Inc
Sibel	Clashe	Heathcote, Boyle and Lehner
Peggy	Trusty	Block LLC
Witty	Farquharson	Toy-Russel
Aurie	Southwood	Reilly, Moen and Douglas
Kalinda	Berling	Dickinson and Sons
Basile	Josipovic	Stokes Inc
Clare	Fick	Mohr-Keeling
Vonny	Holleran	Stokes-Bartell
Faina	Boutwell	Terry-Yundt
Davie	Twinbourne	Gusikowski, Greenholt and Hodkiewicz
Mario	Hitscher	Gislason-Bartoletti
Kalila	Lantaph	Price, Feil and Flatley
Lucien	Dict	Turner Group
York	Sparey	Ratke, Hickle and Streich
Kalinda	Doulton	Rau Group
Merridie	Merrigan	Herman, Walsh and Conroy
Braden	Edgehill	Fahey LLC
Ezri	Roycroft	Mueller, Morissette and Cummings
Bink	Faro	Kshlerin, Greenholt and Jast
Prince	Elcock	Bernhard-Mertz
Harley	Pulbrook	Wilkinson, Kris and Terry
Ford	Solway	Dicki LLC
Neville	Yearsley	Dickinson-Beer
Elayne	Walliker	Satterfield, Purdy and Feeney
Hanna	Urry	Kuhlman-Hamill
Basile	Dahlberg	Kirlin-Feil
Koressa	Tipler	Jacobson, Muller and Schneider
Haywood	Ruffle	Macejkovic and Sons
Edmund	Gane	Wehner, Eichmann and Erdman
Madel	Roles	Considine LLC
Marielle	Adolfson	Homenick-Grant
Gleda	Sedgemore	Schroeder, Jaskolski and O'Hara
Garfield	Coltan	Parisian Inc
Cass	Veighey	Kirlin-Casper
Morrie	Garfath	Mueller Group
Roda	Hecks	Will-Connelly
Peri	Dottridge	Anderson-Lebsack
Ole	Batte	Medhurst Inc
Ripley	Kall	Friesen-Zulauf
Hulda	Bilbery	Hoeger LLC
Clement	Foxcroft	Kozey and Sons
Gwenora	Andreichik	Sawayn, Sauer and Rempel
Arlyn	Catterell	Turner Inc
Mufinella	Corgenvin	Schoen Group
Nissie	Beloe	O'Keefe, Rutherford and Hudson
Mendie	Daveridge	Dickens, Kautzer and Hauck
Pattie	Wrigglesworth	Von, Monahan and Schmeler
Glyn	Callery	O'Hara, Sipes and Hirthe
Dur	Springle	Nolan, Kohler and Thiel
Pet	Imorts	Reichel and Sons
Bert	Banbrigge	Turcotte Inc
Dinny	Quadling	McDermott-Rempel
Latrena	Laxston	Lemke, Von and Glover
Sherrie	Daykin	Gorczany and Sons
Glori	Rash	VonRueden-Cronin
Fredi	Yapp	Tillman-Sawayn
Garrek	Morrow	Carter Inc
Adorne	Bellefonte	Cremin, Fahey and Dicki
Edith	Howerd	Nikolaus-McCullough
Aurore	Hunn	Torphy-Mraz
Erin	Frangello	Schowalter-Zulauf
Sampson	Sandels	Kling-Stoltenberg
Ermin	Lanigan	Keebler, Medhurst and Fisher
Alidia	McGerraghty	Gusikowski-Ferry
Terrel	Juppe	King and Sons
Killy	Kellet	Marquardt-Berge
Sibyl	Whitelaw	Feest LLC
Zane	Elstob	Rosenbaum-Turcotte
Wendeline	Lengthorn	Gerlach Group
Sadie	Seadon	Swaniawski-Eichmann
Charmian	Harnwell	Welch, Doyle and Hintz
Augusta	Moyes	Harber and Sons
Davide	MacGillacolm	Little-Boyer
Gabriele	Desorts	Abbott LLC
Quintus	Silverstone	Zboncak-Dach
Anabelle	Dolbey	Marvin, Emmerich and Medhurst
Bertha	Merfin	Robel-Runolfsdottir
Ev	Dudney	Mills-Wilderman
Jacquelynn	Baythrop	Ziemann, Harris and Smith
Shawn	Neate	Renner-Robel
Albrecht	Abbison	Jakubowski-Macejkovic
Ashbey	How	Orn-Nienow
Inessa	Shearsby	Murphy Inc
Riane	Hylton	Dicki LLC
Jackqueline	Conahy	Turner-Nitzsche
Erma	Winsbury	Yost-Glover
Manolo	Hendrickson	Wilkinson-Towne
Clarance	Leslie	Olson, Considine and Heathcote
Berne	Faughny	Bernier, Toy and Ortiz
Abey	Pringley	Huel Inc
Kelvin	Vitte	Friesen Group
Dallas	felip	Gleason Inc
Gennie	Finley	Nitzsche, Bogisich and Deckow
Neill	Caudrelier	Lubowitz-Gutkowski
Herman	McCord	Davis-Bogan
Daryl	Harvatt	Berge, Witting and Strosin
Myranda	O'Doohaine	Huels, Hammes and Will
Laurette	Colcutt	Balistreri-Reichel
Ber	Bahl	Nader Inc
Corey	Giddons	Pollich, Bednar and Fay
Ashlin	Palfreman	Lebsack, Rempel and Leuschke
Augusto	Letty	Kovacek Inc
Cassey	Thridgould	Brekke-Sipes
Jo-anne	Ramlot	Johnson Inc
Tracey	Berrick	Cremin LLC
Alisa	Ziemens	Upton-Predovic
Malorie	Picard	Paucek Inc
Hinda	Beetham	Jacobson-Denesik
Suzette	Wildman	Kuphal, Mann and Okuneva
Ediva	McEwen	Skiles-Roob
Rafaela	Pfaffel	Kertzmann Group
Tierney	Orme	Sipes Group
Russell	Mardee	Maggio-Fritsch
Zabrina	Allott	Raynor, Prohaska and Legros
Gracia	Alyukin	Kertzmann, Fay and Roob
Hadleigh	De La Haye	Schulist, Kautzer and Cummerata
Kelley	Birmingham	Hodkiewicz-Rau
Nettle	Lovel	Dietrich and Sons
Julieta	Bottoner	Bartell, Roob and Schulist
Myles	Northen	Wyman, Kshlerin and Kautzer
Aigneis	Maha	Konopelski, Hoeger and Sawayn
Ree	McKenney	Bernier, Fahey and Harber
Guthrie	Remer	Oberbrunner, McGlynn and Cassin
Manfred	Ibarra	Homenick Group
Annalee	Synnott	Will-Erdman
Morgana	Dowty	Hintz-Sawayn
Jefferey	Di Matteo	Spinka-Stiedemann
Sybille	Thecham	Robel-Kiehn
Olav	Fryatt	Kemmer-Deckow
Marten	Morrilly	Yost Group
Fey	Krug	Lowe, Schuster and Connelly
Benjie	Seson	Williamson-Anderson
Meade	St Pierre	Zulauf and Sons
Clarine	Frascone	Swaniawski, Grady and Prosacco
Teena	Walthall	Mitchell, Jerde and Kris
Kitti	Brandsma	Kuhlman Group
Annabal	Essberger	Kautzer, Mueller and Schroeder
Meg	Karpf	Walter and Sons
Lina	Spikeings	Nolan, Watsica and Adams
Vida	Nanninini	Hahn, Lehner and Gleichner
Olga	Harryman	Tremblay, Marks and VonRueden
Tedd	Thecham	Satterfield, Ortiz and Kuhic
Alvinia	Elphinston	Torphy LLC
Shepherd	Clifford	Lind-Christiansen
Jessee	Dodshon	McDermott LLC
Hastings	Collopy	Gutmann Group
Gallagher	Devorill	Hayes-Collins
Lettie	Narraway	Leannon Group
Glennis	Robillard	Turner, Mertz and Feil
Marisa	Manes	Friesen-Cruickshank
Ann	Tatlowe	Wintheiser-Maggio
Lisa	Muat	Huels, McGlynn and Rolfson
Tallia	Gilfoy	Lueilwitz, Bode and Wolff
Poppy	Dundon	MacGyver, Weber and Weissnat
Vidovik	Padginton	Pfannerstill, Doyle and Bartell
Deni	Emanueli	Konopelski, Rice and Hessel
Layne	Cross	McDermott Group
Jude	Tuttle	Legros-Yost
Sonny	Pierse	Yost Group
Ronica	Emilien	Bogisich, Effertz and Mosciski
Cleon	Dubble	Lang Inc
Patric	Cudbertson	Johnson-Hagenes
Johnna	Loreit	Kling Inc
Maisie	Winborn	Purdy, McKenzie and Mills
Roana	Huburn	Schoen-Kulas
Leandra	Sikora	Reinger, Abbott and Langosh
Jonie	Putson	Roberts-Prohaska
Pacorro	Calvey	Macejkovic Group
Meghan	Swapp	Wisozk-Bartell
Gregoire	Gull	Jerde, Gutmann and Schuppe
Kennan	Springtorp	Hayes, Tillman and Kessler
Kenton	Mityushin	Harber, Douglas and Renner
Quintana	Rosenfrucht	Morar-Kunze
Sibley	Webley	Turner, Yost and Block
Heindrick	Bothram	Padberg-Deckow
Rebe	Arnaudet	Bauch-Doyle
Selma	Arnatt	Howell, Labadie and Skiles
Clementia	Haycock	Feest LLC
Yolande	Lougheid	Runte Inc
Roxy	Rawsthorn	Kub, Hirthe and Kertzmann
Constantia	Pellatt	Bartoletti-Denesik
Adolphe	Costain	Braun-Becker
Bary	Yakebovitch	Kassulke-Schulist
Lorrin	Harnetty	Parker and Sons
Storm	Salack	Howell-Fay
Uta	Orleton	Mann-Swaniawski
Monica	Bugs	Stokes Group
Xavier	Corrington	Leffler Inc
Joceline	Broomhall	Pagac, Sanford and Block
Melinda	Rennles	Bailey, Sanford and Weissnat
Rhianon	Bellefonte	Denesik Inc
Felicle	Coulston	Streich-Fahey
Bryana	Croyser	Batz Group
Hamnet	Spurdle	Littel-Brakus
Robbin	Hugk	Wisoky-Stiedemann
Madlin	Cattel	Crona LLC
Tiffani	Avrahamoff	O'Hara Group
Mattheus	Meeny	Reilly, Runolfsdottir and Thiel
Alysa	Capon	Carter and Sons
Kesley	Gladyer	Zieme Inc
Husein	Moncaster	Bayer and Sons
Sherwin	Jirick	Heidenreich, Bartoletti and Fritsch
Templeton	Staten	Lind LLC
Gabrielle	Shipman	Vandervort Inc
Tadd	Staite	Hayes Inc
Vern	Duffett	Schaefer Group
Meier	Matic	Hessel LLC
Paulie	Oselton	Yundt Inc
Raimondo	Bilson	Abbott, Senger and Hayes
Muriel	Kerrigan	Gutmann-Bernier
Mitch	Probart	Gerlach, Veum and Casper
Inglebert	Robertz	Davis-Marquardt
Merwyn	Allsworth	Padberg-Rippin
Ivonne	Minnis	Gusikowski Group
Cosette	Schrader	Reichert Group
Bernardo	Hempshall	Zboncak Group
Kevyn	Abley	King-Bogisich
Rena	Champ	Abbott-Schultz
Vidovic	Labram	Botsford, Monahan and Bechtelar
Stesha	Zannutti	Hamill-Ortiz
Antonina	Anwell	Pfeffer LLC
Thalia	Sidon	Towne, Orn and Krajcik
Anatol	Burberow	Schroeder Inc
Dimitri	Sterman	Weber, Fahey and Schneider
Stephi	Minear	Braun, Wunsch and Steuber
Petunia	Anstee	Lowe-Turcotte
Zelda	Royan	Wisozk-Ryan
Ingar	Pletts	Wehner, Macejkovic and Grant
Tildi	Tomasek	Rohan-Welch
Joelly	Calan	Douglas-Ratke
Joey	Vanyutin	Kovacek-Conroy
Cleon	Carthew	Schroeder, Torp and Ankunding
Thorny	Tarzey	Lynch, Langosh and O'Conner
Lilith	Dugmore	Borer, Schroeder and Schinner
Ilse	Milmith	Gerhold-Rau
Erina	Magnus	Ferry, Dicki and Will
Monique	Cutchie	O'Conner-Hahn
Shep	Lipson	Bechtelar-Marvin
Aretha	Shera	Stracke-Bednar
Rebe	Cicchillo	Reichel-Hauck
Rick	Beacon	Weber-Bartoletti
Jaquenette	Shepcutt	Moen-McGlynn
Gilles	Stoeck	Corwin Group
Myrtia	Calliss	Mohr, Lindgren and Wehner
Sigismond	Phelipeau	Sanford Inc
Guinna	Reyson	Hartmann and Sons
Gui	Parysowna	Nolan, Kutch and DuBuque
Langsdon	de Leon	Gleason, Ebert and Walter
Kettie	Selley	Carroll-Hansen
Barn	Thurlborn	Kulas LLC
Moore	Benjafield	Witting-Legros
Logan	Jean	Heathcote-McGlynn
Brittney	Small	Murray LLC
Elijah	Forrest	Paucek Inc
Jobie	Borrill	Leffler-Senger
Karalee	Darbon	Swaniawski-Larkin
Ewan	Bensley	Conn-Bartell
Danette	Golthorpp	Tremblay, Hills and Marks
Clea	Rookes	Beer-Lesch
Mirabelle	Bacher	Abshire-Fadel
Lemuel	Walder	Lynch-Larkin
Ailbert	Norheny	Stroman, Kuphal and Schroeder
Sax	Lelliott	Kilback-Halvorson
Freddy	Sired	Adams-Murray
Rayner	Attwill	Walker Group
Abbot	Yeoland	Will and Sons
Jackquelin	Snugg	Lebsack-Kris
Carlyn	Pennrington	Rolfson, Hoppe and Cronin
Briano	Baptista	Walter-Okuneva
Danny	Cosser	Witting-Windler
Decca	McLukie	Leuschke Group
Bevon	Eldridge	Rau, Weimann and Champlin
Marketa	Sands-Allan	DuBuque, Botsford and Bahringer
Pollyanna	Piccop	Harvey LLC
Gibbie	Ivic	Kozey-Kessler
Brendon	Lampaert	Denesik-Wunsch
Perri	Jude	Hagenes LLC
Myranda	Accum	Morar, Dare and Cronin
Lenci	Itzkovici	Botsford-Gaylord
Bay	Cassie	Hills, Heller and Hoppe
Natividad	MacNamara	McKenzie Inc
Heidie	Fishly	Armstrong, Lubowitz and Schamberger
Richy	Bernocchi	Pfannerstill-Zboncak
Skyler	Haldenby	Kerluke Group
Delmar	Dibbs	Jast-Moore
Norman	McCard	Johnston, Cronin and Kunze
Elyssa	O'Corhane	White-Kreiger
Gal	Ruggieri	Heaney, Pouros and Sporer
Brittney	Diamond	Becker and Sons
Sonnie	Fowley	Dibbert, Murray and Bogan
Stephanie	Clift	Stanton, Mertz and Kris
Loria	Throughton	Block and Sons
Dosi	Craister	Rohan Group
Shell	Kunkler	Collins-Wunsch
Lyn	Denkin	Leannon, Jacobson and Rath
Berti	Pengilley	Mraz-Reichert
Warde	Beddo	Kiehn-Zemlak
Gabey	Phoenix	Ruecker-Conn
Herrick	Kimmons	Klein, Johnston and Smitham
Desirae	Swate	Monahan-Zulauf
Gert	Lamball	Reilly, Gorczany and Terry
Shirley	Kohnen	Prosacco, Ledner and Bradtke
Chryste	Rawlin	Gulgowski-Schiller
Jakob	Millberg	Heller, Olson and Okuneva
Stephie	Meachen	Dach-Baumbach
Lizette	Lorimer	Will, Zemlak and Carroll
Egon	M'Quharg	Jacobi and Sons
Colman	Sears	Crist-Cormier
Nicki	Hamblin	Ratke Inc
Godfree	Kuhn	Luettgen-Howell
Winslow	Metheringham	Roberts Group
Yehudi	Munson	Carroll Group
Bartolemo	Deighan	Conroy and Sons
Adiana	Descroix	Koch-Douglas
Torrence	Gilliland	Harvey-Upton
Rosalia	Priddle	Smitham and Sons
Catlaina	Pollins	Reichert, Balistreri and Berge
Joane	Scannell	Ullrich LLC
Osmund	MacAdam	Rice, McClure and Stehr
Emmye	Youings	Becker Group
Tiena	Davana	DuBuque Inc
Gregg	Roakes	Zemlak, Kautzer and Willms
Maggi	Burridge	Mosciski and Sons
Leigh	Sedger	Hoeger-Gulgowski
Marlene	Whorall	Stanton Inc
Enoch	Swithenby	Baumbach-Moore
Lucas	Buffham	Batz Inc
Alysa	Griffitt	Ratke LLC
Fran	Pero	Yost, Pfannerstill and Reynolds
George	Arkwright	Conn-Grady
Eldridge	Peggrem	Watsica LLC
Christophe	Lorryman	Shanahan, Ernser and Berge
Karim	Laroux	Heathcote, Daniel and Kutch
Clemens	Stanworth	Raynor, Pollich and Parker
Randolph	Ibbs	Olson and Sons
Dagny	Di Francesco	Dare LLC
Sherlocke	Ingreda	Langworth-Hauck
Shayna	Kobera	Gislason-Conn
Sonnie	Paslow	Paucek-Strosin
Beitris	Peregrine	Bruen-Simonis
Genny	McGawn	Larson, Kris and Beer
Elias	Lazer	Runolfsson-Lockman
Kristo	Yes	Tremblay-Schuster
Doralin	Ivanin	Schaden, Emmerich and Huels
Tessie	Mangon	Casper, Rowe and Lockman
Del	Powton	Nikolaus, Stiedemann and Bahringer
Bailey	Zoephel	Beatty, Rodriguez and Gislason
Marta	Doone	Balistreri Inc
Fabe	Tunnock	Senger-Okuneva
Gibby	Bouchard	Dicki-McKenzie
Barbee	Gauvain	Hagenes and Sons
Brittany	Harsent	Harvey Inc
Ibrahim	Ranscomb	Keeling, Kuhic and Grimes
Patti	Humbatch	Welch-Metz
Lynnette	Bernardos	Ankunding and Sons
Stearne	Feedome	Adams Group
Stanley	Beddin	Bernhard, Johns and Nitzsche
Daisie	Levinge	Volkman Inc
Florentia	Stathers	Frami, Feest and Abbott
Charlotte	Kennelly	Collier-O'Reilly
Dyanna	Bartosinski	Auer-Hegmann
Christy	Redhouse	Mertz-Kuhic
Madalena	Fossord	Russel and Sons
Taddeo	Pele	Schoen Group
Cherida	Foster	Donnelly, Collins and Christiansen
Ree	Claffey	Carter, Quigley and Johnson
Royall	Lachaize	Lakin-Friesen
Jacquenette	Lygo	Aufderhar-Hamill
Jeremie	Chrystal	Stokes-Weimann
Thain	Jirick	Thiel-Spinka
Winnah	Sydenham	Feest-King
Salome	Kilty	Gerhold, Nienow and Mertz
Karney	Brickwood	Bogisich Group
Hashim	Rosenbloom	Spencer, Ziemann and Rosenbaum
Salomi	Meenehan	Walsh, Conroy and Purdy
Talia	Ditter	Rowe Group
Etheline	Branston	Beier, Douglas and Stiedemann
Marwin	Bustin	O'Kon-Kessler
Averyl	Gladbach	Bode Group
Guthrie	Delhanty	Luettgen, Dietrich and Raynor
Manfred	Adamovitch	Bruen, Hyatt and Willms
Gaby	Edgars	Bogan Group
Daphne	Findlater	Stark-Sipes
Christiano	Giannazzi	Larson, Botsford and Beatty
Hayley	Landis	Kessler Inc
Lazarus	Twycross	Kunde, Parisian and Rutherford
Gabriella	Scholer	Witting-Roob
Uri	Baitey	Beier Group
Zaria	Wilton	Stamm Inc
Glenna	Battabee	Wisoky Inc
Ambur	McGilbon	Rodriguez, Durgan and Carroll
Deanne	Pochon	Leuschke, Russel and Cronin
Kirstyn	Orsman	Collier, Mills and Rogahn
Max	Ready	Predovic-Watsica
Xymenes	Price	Hagenes, Stark and Roberts
Freida	Kreuzer	Smitham, Labadie and Weissnat
Shawn	Olivazzi	Ziemann-Spencer
Augustine	Maddocks	Lesch, Hackett and Feil
Valeria	Philipsen	Stiedemann-Barton
Ricca	Drawmer	Zulauf-Hintz
Dawna	Patient	White LLC
Patrica	Cansdall	Hessel LLC
Dana	Constanza	Harris Inc
Isiahi	Umbert	Satterfield-Gulgowski
Jdavie	Kidman	Schinner-Renner
Fairleigh	Perett	Emard, Marquardt and Towne
Ray	Docharty	Kassulke, Hoppe and Lesch
Jonathon	Carnson	Price, Romaguera and Lowe
Darrell	Bellord	Gerlach, Gorczany and Baumbach
Thane	Noon	Labadie-Pouros
Shanta	Dillamore	Hartmann-Rath
Charley	Runciman	Toy-Raynor
Keith	Canaan	Mante-Balistreri
Ewell	Droghan	Feest, Fay and McDermott
Ailina	MacNeilly	Ritchie, O'Connell and Yundt
Ceciley	Corr	Hegmann-Walsh
Vinny	Fuzzey	Cole and Sons
Kathy	Frushard	Bradtke Group
Idell	Seakin	Metz-Cummings
Ynes	Swine	Fisher-Thompson
Marilee	Edelmann	Quigley, Willms and Heathcote
Phyllys	Grabban	Oberbrunner, Daugherty and Littel
Cati	Dodgshun	Hettinger, McDermott and Hegmann
Grace	McCullen	Steuber LLC
Cele	Fibbit	Emard Group
Genna	Melliard	Mueller, Bartoletti and Pacocha
Anselm	Hedworth	Vandervort LLC
Ailina	Linning	Hilll LLC
Blakeley	Opie	McLaughlin Inc
Bettine	Note	Schmeler and Sons
Keen	Crowley	Price and Sons
Clair	Primarolo	Bahringer, Torphy and Beahan
Ilse	Kermode	Nikolaus, Schowalter and Waters
Fancy	Nutman	Wiegand Inc
Theo	Woodburne	Roberts, Oberbrunner and Mitchell
Doe	Guiden	Schuster-White
Artair	Puvia	Simonis LLC
Roseline	Allner	Graham Inc
Blondelle	Menzies	Stamm Inc
Loralie	Vannah	Witting Inc
Reggis	Pask	Schaefer, McKenzie and Kuhn
Tadd	Durbridge	Lebsack-Gleichner
Starlene	Addison	Hegmann and Sons
Anna-maria	Hawker	Gislason, Bergstrom and Kessler
Gene	Heaps	Wilkinson Group
Alica	Cuddon	MacGyver-Huel
Julee	Skey	Little Inc
Chickie	Lichtfoth	Wintheiser Inc
Barnie	Widmore	Wiza, Wiegand and Gleichner
Levon	Huntly	Thompson Inc
Tania	Hanshaw	Green Group
Murdock	Jozaitis	Brekke, Koss and Wuckert
Adria	Bittleson	Frami and Sons
Essy	Blissitt	Walsh, Breitenberg and Rice
Maddie	Kalb	Williamson, Haag and Nader
Brad	Smithyman	Rosenbaum LLC
Colan	McKendo	Runolfsdottir and Sons
Lowrance	Spilsbury	O'Kon, Stoltenberg and Steuber
Elli	Licence	Weimann-Cummerata
Flossy	Stuchburie	Mills-Wolff
Valdemar	Fairlamb	Friesen, Ledner and Smith
Fannie	Dix	Pfeffer and Sons
Raddie	Gurney	Kub, Baumbach and Stehr
Benny	Pierrepoint	Jaskolski, Runolfsson and Mohr
Monti	Skypp	Roberts-Wolf
Guss	Kleen	Moore, Spinka and Grimes
Nelly	Robb	Murazik-Bailey
Archibold	Croux	Schimmel, O'Hara and Kuhlman
Ellen	Merlin	Fritsch-Spinka
Esme	Clabburn	Gottlieb, Moore and Kuhlman
Nana	Bayfield	Volkman, Wisoky and Stoltenberg
Adena	Sutty	Deckow-Kuvalis
Shina	De Avenell	Stanton and Sons
Addia	Shoulder	Moen, Greenfelder and Kling
Sara	Urien	Fisher LLC
Angelica	Yitshak	Reynolds-Bergstrom
Melitta	Spackman	Pagac-Wuckert
Stuart	Beardsworth	Bartoletti-Jakubowski
Levey	Brumen	McKenzie-Yost
Gladi	Durno	Swaniawski-Beier
Guntar	Maskall	Hermann-Purdy
Sax	Odegaard	Cassin, Balistreri and Wiegand
Kenneth	Deakes	Zieme and Sons
Vidovik	De L'Isle	Dooley, Kling and Doyle
Claire	Tacon	Pfeffer, Corkery and Buckridge
Jakie	Hamper	Rippin-Hoeger
Hunt	Bon	Runolfsdottir-Witting
Luise	Crosland	Breitenberg, Orn and Konopelski
Selie	Fowell	Wisozk, Welch and Gottlieb
Constantina	Jillins	Muller-Bernier
Osbert	Szymanowski	Haag-McDermott
Dom	Bachman	Langworth Inc
Thornton	Lamburn	Littel Group
Charmain	Tomowicz	Rempel, Wuckert and Kuhn
Andres	Gerant	Lakin, Willms and Waters
Inger	Bigby	McCullough LLC
Barry	Maybery	Schoen and Sons
Brose	Ierland	Wisozk and Sons
Stern	Bank	Jacobs Inc
Tommy	Roller	Wiegand, Bahringer and Olson
Ado	Osgorby	Homenick-O'Connell
Nyssa	Podd	Schneider, Runolfsdottir and Graham
Courtney	McCarry	Monahan LLC
Jenn	Van T'Hoog	Hessel, Robel and Rippin
Stephani	Devon	Cormier, Herzog and Lang
Addie	Sondon	Keeling-Smitham
Celesta	MacRury	Hagenes-Cronin
Ysabel	Vallentin	Stamm LLC
Ferguson	Brothwood	McClure LLC
Cece	McRobbie	Gaylord LLC
Ennis	MacGovern	Hyatt-Walker
Emili	Stevings	Trantow, Lemke and Brakus
Decca	Zannutti	Senger-Von
Coleen	Liddington	Runte, Paucek and Gerhold
Edithe	Langeren	Johnston Group
Augustin	O'Dyvoy	Stanton LLC
Herby	Karran	Dooley-Spinka
Carmen	Grube	Mayer-Schulist
Nolie	Gyorgy	Kautzer Inc
Eryn	Lages	Crooks and Sons
Munmro	Brocklebank	Nicolas Inc
Gregoor	Sutherland	Yundt LLC
Annemarie	Grayson	Murphy, Ziemann and Greenholt
Joshuah	Bearward	Deckow and Sons
Elvina	Storrs	Hand, Crona and Upton
Adela	Velasquez	Pfannerstill LLC
Dale	Reeday	Fisher-Bosco
Annalise	Bambrugh	Jacobson, Bode and Ortiz
Orelie	Tring	Adams, O'Kon and Wunsch
Ricky	Malser	Friesen-Wolf
Myrna	Frensche	Batz and Sons
Antonie	Olcot	McClure and Sons
Lacee	Leele	Schuppe, Schinner and Heaney
Kellen	Drowsfield	Zemlak Group
Ximenez	Van Velden	Carroll, Toy and Bogan
Kath	Meecher	Braun LLC
Birgitta	Trenholm	Zboncak, Hoeger and Lesch
Myrwyn	Jewson	Kemmer-Thiel
Alexio	Aspole	Ullrich-Greenholt
Cully	Pietesch	O'Keefe Group
Micaela	Lovekin	Mann, Medhurst and Osinski
Randi	Methuen	Maggio, Greenholt and Dicki
Harman	Inston	McGlynn, Crona and Feeney
Heida	Cargon	Larkin-Roob
Jo	Jakuszewski	Powlowski, Morar and Monahan
Calhoun	McLinden	Crooks, Senger and Moen
Caroljean	Gaggen	Williamson-Jenkins
Alfonso	Borg	Harber and Sons
Alley	Denyakin	Toy-Herman
Pam	Jaeggi	Nienow-Kunde
Brew	Bauchop	Runolfsson LLC
Nicola	Bridgeland	Price-Nader
Brantley	Juckes	Bechtelar Group
Viviyan	Kaszper	Murphy, Corkery and Brakus
Camey	Hanratty	Stanton-Quitzon
Aurthur	Monteaux	Kulas-Carroll
Lothario	Brine	Gerhold-Kiehn
Mario	Bednell	Skiles LLC
Raine	Dyett	Walsh, Konopelski and Dooley
Hughie	Radcliffe	Gerhold-Orn
Branden	Dunstan	Brekke, Towne and Huel
Cal	de Villier	Barton-Doyle
Dicky	Hardison	Cremin, Bartoletti and Ritchie
Burgess	Websdale	Rosenbaum, Murray and Purdy
Isac	Pappin	Kulas-Schowalter
Margret	McElrea	Greenholt-Nader
Quintina	Clive	Padberg-Jenkins
Nathanial	McHenry	Lebsack and Sons
Kelbee	Fellows	Krajcik Inc
Waldemar	Cutts	King-Satterfield
Jaquelin	Pacitti	Bartell-Rodriguez
Giffie	Clendening	Blanda-Stroman
Rabbi	Bilby	Steuber, Johnson and Wunsch
Floyd	Domange	Jenkins LLC
Nikolos	Hayworth	O'Conner-Deckow
Jannelle	Ivetts	Moore Inc
Dorrie	Durnian	Jacobson-O'Hara
Suzie	Tivenan	Zboncak-Fisher
Erwin	Glanz	Zieme, Towne and Glover
Kris	Deerness	Parisian and Sons
Alvera	Rookledge	Barrows Inc
Ryan	MacVagh	Gusikowski-Leuschke
Cordy	Olsen	Champlin-Weimann
Dillon	Colbran	Corwin-Gislason
Tobe	Kemer	Hagenes, Abshire and Goyette
Kalvin	Mariot	Kozey LLC
Darya	Rogliero	Herzog, Hudson and Hamill
Curcio	Welford	Pfeffer-Schaefer
Sharla	Hallstone	Russel LLC
Ebba	McFall	Roberts-Wilkinson
Armand	Rotham	Jakubowski-Hickle
Barn	de'-Ancy Willis	Schmeler-Bergnaum
Ford	Grayshon	Barton, Conroy and Roberts
Devi	Toal	Larson Group
Bryanty	Yitzovicz	McLaughlin, Bosco and Harris
Laurent	Setter	Gleason, Nitzsche and Mann
Bonni	Breed	Feil, Klein and Halvorson
Mathilda	Vasyuchov	Heathcote, Hahn and Dach
Dulcine	Hewkin	Mosciski, Hahn and Schmidt
Rafa	Ranyell	Will and Sons
Birgit	Higounet	Fadel, Watsica and Bogisich
Violante	Vlasyev	Dach, Graham and Lang
Britt	Olpin	Hermiston Inc
Leopold	May	Gaylord Inc
Davina	Croxton	Beer and Sons
Costanza	Auguste	Donnelly-Maggio
Annette	Bernon	Morar, Haley and Flatley
Aldin	Ditt	Harris Inc
Dun	McMeyler	Nienow-Hickle
Romonda	Blodgetts	Harber, Abshire and Franecki
Lila	Mozzi	Beahan Group
Claresta	Guisby	Schultz, Hills and Erdman
Antoinette	Vosper	Lehner LLC
Krista	Hodgon	Ruecker, Block and Ledner
Ibrahim	Yare	Kihn Group
Syd	Tethcote	Kreiger Group
Willie	Hutcheons	Bins, Champlin and Metz
Merv	Cockerell	Bartoletti-Stoltenberg
Betti	Smelley	Goyette, Lemke and Dietrich
Keelia	Cowderoy	Ledner LLC
Desmund	Cockroft	Quigley-Altenwerth
Malory	Symper	Strosin, Erdman and Kiehn
Harriette	Trudgion	McDermott, Feil and Powlowski
Carmella	Piatek	Gaylord, Gutmann and Bayer
Hirsch	Dockrey	McCullough Group
Waylen	Klimes	Collins Group
Kissee	Hellikes	Miller-Dach
Jessamyn	Gellier	Johnson, Schroeder and Bashirian
Donnell	Scardifeild	Hickle LLC
Davine	Bayne	Vandervort-Lowe
Boone	Booth-Jarvis	Ziemann-Johnson
Diane-marie	Hughlock	Shanahan-Stiedemann
Robinet	Galea	McLaughlin and Sons
Ramon	McCarron	Reilly, Sawayn and Schiller
Dacia	Dewett	Hyatt and Sons
Noemi	Rosberg	Runolfsdottir-Kerluke
Corinna	Verrills	Dare-Rice
Beret	Tedorenko	Pacocha LLC
Nappy	Binion	Purdy, Stroman and Vandervort
Vevay	Antyshev	Kerluke, White and Hahn
Base	Banat	Feeney-Feest
Sargent	Starling	Labadie-Hilll
Lidia	Durrad	Koch, Rempel and Gutkowski
Joseph	Whannel	Bruen-Schumm
Huntington	Elger	Murray Inc
Elita	Lintot	Corwin, Tremblay and Corwin
Vachel	Drewet	Toy-Russel
Marie	Sterzaker	Ziemann LLC
Bevvy	Giovanizio	Adams and Sons
Cleon	Keppie	Lehner-Sporer
Wilfrid	Franc	Price-Franecki
Robinet	Dow	Mosciski-Kertzmann
Penny	Arnaldi	Moore and Sons
Cathee	Blacktin	Bernhard Group
Thaine	Chadwyck	Schmitt, MacGyver and Keebler
Shay	Lamort	Cremin, Wiegand and Bechtelar
Karil	Collier	Spinka Group
Claudius	Sharrier	Ruecker-Rosenbaum
Aaron	Williscroft	Blick, Baumbach and Roob
Ephraim	Welfair	Robel-Flatley
Chet	Grafhom	Kohler Inc
Rooney	Revington	Ritchie-Weber
Morley	Semarke	Borer-Osinski
Roberta	Scrogges	Block LLC
Murdoch	Bettam	Fritsch Inc
Othelia	Downe	Cassin, O'Reilly and Mueller
Lela	Betteson	Hammes, Gislason and Keeling
Spenser	Brome	O'Kon Group
Anstice	Bonniface	Bauch Inc
Jacobo	Struss	Nader Group
Zaccaria	Le Moucheux	Cremin Inc
Fern	Reiglar	Kshlerin, Daugherty and Balistreri
Ashby	MacKee	Lehner-Oberbrunner
Xena	Click	Russel-Rowe
Niki	Codner	Hilpert, Schinner and Price
Anjanette	Grimshaw	Legros and Sons
Dougy	Whoston	Franecki Group
Colver	Roughey	Padberg-Hermiston
Rex	Covil	Johns Inc
Nanette	Flattman	Auer-Volkman
Dennie	Raddon	Rogahn, Mueller and Lubowitz
Ramona	Harding	Purdy, Tillman and Borer
Lowe	Zorzetti	Shields, Emard and Wuckert
Ninnette	Pedrocchi	Bogan-Wilkinson
Gawain	Triswell	O'Connell-Grant
Quintus	Corington	Orn Inc
Cori	Morrill	Wilkinson, Sanford and Friesen
Jada	Guterson	Rippin-Eichmann
Maridel	Garnham	Kerluke-Gorczany
Sabine	Jarvie	Cartwright, Trantow and Simonis
Garret	Nowakowska	Reichert and Sons
Theo	Haggard	Barton, Quitzon and Moore
Carmine	Dunston	Dach-Prohaska
Charline	Pickton	Champlin-Hessel
Eydie	Kamena	Kuhlman, Balistreri and Beer
Tadio	Ingle	Tromp, Smith and Borer
Sibilla	Michelotti	Thompson-Schulist
Edna	Doorly	Mraz and Sons
Bendix	Crichten	Brown-Bashirian
Kaila	Kettlestringes	Bernhard, Lang and O'Kon
Roosevelt	Goscomb	Breitenberg and Sons
Morten	Aitkenhead	Brakus Group
Massimiliano	Quade	Schmeler and Sons
Anica	Tolley	Bednar-Rau
Jeffie	Insull	Bartell Group
Greggory	Searight	Smitham and Sons
Essa	Coe	Schmitt, Klein and White
Nels	O'Rodane	Satterfield-Stark
Delmer	Brede	Lindgren LLC
Griffie	Regina	Corkery-Hartmann
Camala	Wadworth	D'Amore, Braun and Satterfield
Stevana	Burnside	Rempel, Will and Tillman
Colin	Pollitt	Leannon-Wilkinson
Berne	Lingley	Anderson, Schuppe and Schmeler
Feliza	Cleaveland	Cartwright, Purdy and Senger
Cherry	Booij	Altenwerth, Luettgen and Pollich
Brunhilda	Kendrew	Botsford-Blick
Buddie	Little	Hoeger and Sons
Vonny	Futter	Rutherford LLC
Angy	Petigrew	Bogan, O'Conner and Gusikowski
Charlotte	Ellson	Cremin, O'Kon and Terry
Florie	Grundy	Schimmel Inc
Quintina	Cham	Hilll, Bosco and Shanahan
Brody	McIlraith	Hintz-Herzog
Haywood	Baitman	Ankunding, Mills and Feest
Marsh	Straun	Hoeger Group
Kameko	Vittori	Kohler and Sons
Elicia	MacFaell	Mueller-Parker
Free	Gummery	Rowe and Sons
Roscoe	Stucke	Ebert Group
Quincey	Tims	Terry, Rempel and Keeling
Libbi	Geydon	Morissette-Powlowski
Paulo	Officer	Boyle Group
Vonnie	Liddel	Padberg-Beahan
Annmarie	Heak	Braun, Ebert and Schinner
Morton	Geeritz	Goyette, McCullough and Wilderman
Johny	Tankus	Rohan and Sons
Laney	Saward	Roberts-Bode
Gaspar	Bambrick	Osinski-Ankunding
Leanora	Honig	Jaskolski-Koelpin
Nollie	Sallnow	Fadel, Schiller and Deckow
Deina	Sigars	Harber LLC
Mollee	Winteringham	Mills Group
Marlyn	Cockaday	Eichmann, Gutkowski and Haag
Tadeas	Longmaid	Rolfson Group
Lind	Pinilla	Upton, Ratke and Corwin
Tucker	Garrit	Wiegand Inc
Roley	Sloat	Klocko-Jacobs
Arthur	McVicar	Powlowski-Grady
Shannen	Elsip	Koch, Willms and Emard
Spenser	D'Souza	Dooley-Konopelski
Mathian	Burcombe	Goldner-King
Storm	Quilleash	Nitzsche-Osinski
Anet	Duffield	Bauch and Sons
Genvieve	Corbould	Daugherty, Rowe and Hayes
Mord	Stoade	Ryan and Sons
Jenica	Spain-Gower	Schmidt, Balistreri and Feeney
Ellyn	Syde	Shanahan, Langworth and Luettgen
Sonnnie	Jehaes	Keeling-Wisozk
Devin	Tuiller	Corkery, Jenkins and Wolff
Eddie	Antonacci	Marquardt-Kling
Sydney	Jackling	Langosh-Simonis
Emmy	Aggus	Lindgren Group
Zoe	Lawley	Hamill Group
Jasun	Cheyne	Ryan-Vandervort
Bekki	Tock	Fay Inc
Nicko	Itzkovsky	Gibson, Wilkinson and Brakus
Noell	Barton	Keebler-Dickens
Nerta	Mainson	Stoltenberg-Schamberger
Tony	Bazylets	Wintheiser Group
Robert	Leades	Luettgen-Zieme
Lilah	Woolfenden	Harvey, Hilll and Glover
Lora	Carnihan	Turcotte LLC
Amitie	Moulsdall	Eichmann, Barrows and Stanton
Mariele	Andrews	Ullrich LLC
Jennine	Copestick	Lynch, Morissette and Howe
Raddy	Sanbrook	Kihn and Sons
Gabie	Becerro	Kerluke-Mertz
Bertrando	Rainon	Miller, Keeling and Yost
Reinaldos	Demsey	Adams, Daniel and Larkin
Dyan	Adamovicz	Schumm, Miller and Corkery
Regan	Teggin	Bailey, Cremin and Lebsack
Goraud	Tricker	Carter Inc
Sallyann	Muckley	Mills LLC
Frasco	Heijne	Schaefer-Bode
Traci	Cottham	Becker-Langworth
Kalle	Apps	Schaefer, Wisozk and Mraz
Ericka	Davitti	Ryan, Walker and Runte
Tybi	Espinay	Mosciski LLC
Renie	Tolchar	Purdy-Klein
Luise	McLagain	Goodwin, Rowe and Hane
Jorry	Davidowich	Hand-Johnson
Sara-ann	Kollas	Hyatt, Keebler and Mills
Garner	Hunton	Bogisich, Donnelly and Robel
Junina	Burgin	O'Connell-Quigley
Royal	Vampouille	Gerlach-Schmidt
Constantine	Cashin	Barton-Kreiger
Kay	Bendtsen	Bogan, Ruecker and Price
Flory	MacRirie	Okuneva Group
Marmaduke	Dallison	Huel-Goyette
Barbee	Blurton	Walter-Kessler
Tull	Adamkiewicz	Gutkowski Inc
Louie	Bitcheno	Lebsack LLC
Corinne	Wellington	Fadel-Ratke
Waverly	Barstow	Schmidt-MacGyver
Hershel	Gulleford	Huels, Conroy and VonRueden
Evered	Yewdall	Corkery-Durgan
Rog	Mary	Stracke, MacGyver and Roberts
Flori	Matczak	Kunde Inc
Trina	Bilsford	Hyatt, Weissnat and Schoen
Clark	Howgate	Weimann, Legros and Lind
Sarita	Barhims	Bergstrom and Sons
Jobyna	Dallmann	Schmeler Inc
Packston	Pettifor	Kshlerin, Quitzon and Bogisich
Madalena	Wong	Koch and Sons
Ferdinand	Doughton	Walsh and Sons
Robinette	Wrenn	Ernser-Harber
Suki	Lerigo	Fay-Beahan
Rory	Rutherforth	Ryan-Nienow
